1111111111111
100E0000000C1
11111111P0001

1111111111111