1111111111111111111
1P00000000C00000001
11111111111111100E1
1111111101111111110