1111111111111
1C100000110P1
1010000001101
1010010000001
1000010000001
1111111111101
1000000000001
1C00000000001
1111101111111
1E00000000001
1111111111111