111111111111111
10P111110000001
10011111E000001
100100111111001
10000C11C000001
100000110000001
111100110011111
1111001100000C1
111100000000001
111111111111111