111111111111111
1P01111100000Y1
10011111E000001
10010C111111001
10000011C000001
1Y0000110000001
111100110011111
111100110000001
1111000000000C1
111111111111111