11111111
10000001
10P0C0E1
10000001
11111111